"0","terrain.colors(n = 12)"
"1"," [1]"
"1"," ""#00A600"""
"1"," ""#24B300"""
"1"," ""#4CBF00"""
"1"," ""#7ACC00"""
"1"," ""#ADD900"""
"1"," ""#E6E600"""
"1"," ""#E8C727"""
"1"," ""#EAB64E"""
"1"," ""#ECB176"""
"1"," ""#EEB99F"""
"1"," ""#F0CFC8"""
"1"," ""#F2F2F2"""
"1","
"
